# Slang / Shorthand

bye	goodbye
gonna	going to
hi	hello
ol'	old
'sup	what is up
thanks	thank you
wanna	want to
mon	monday
tue	tuesday
tues	tuesday
wed	wednesday
thu	thursday
thur	thursday
thurs	thursday
fri	friday
sat	saturday
sun	sunday
jan	january
feb	february
mar	march
apr	april
jun	june
jul	july
aug	august
sep	september
sept	september
oct	october
nov	november
dec	december
